1 0 1 1 0 0 0 
0 0 0 0 2 0 0 
0 0 0 3 0 0 0 
0 0 0 0 0 0 0 
0 5 0 0 0 0 0 
0 0 0 0 0 0 0 
0 0 0 0 0 0 0 
0 0 0 0 0 0 0 
0 0 0 0 0 0 0 
0 0 0 0 0 0 0 
0 0 0 0 0 0 0 
0 0 0 0 0 0 0 
0 0 0 0 0 0 0 
0 0 0 0 0 0 0 
0 0 0 0 0 0 0 
12
0 4 1 2
1 3 2 2
3 4 4 2
3 5 4 2
5 3 6 2
6 2 7 2
7 0 8 2
7 1 8 2
8 5 9 2
8 6 9 2
9 2 10 2
9 3 10 2