1 0 0 0 0 1 0 
0 0 0 2 0 0 0 
0 0 0 0 0 0 0 
0 0 0 0 0 4 0 
0 5 0 0 0 0 0 
0 0 0 6 0 0 0 
0 0 0 0 0 0 0 
0 0 8 0 0 0 8 
9 0 0 9 0 0 0 
0 0 0 0 10 0 0 
0 0 0 0 0 0 0 
0 0 0 0 0 0 0 
0 0 0 0 0 0 0 
0 0 0 0 0 0 0 
0 0 0 0 0 0 0 
8
0 5 1 1
1 4 2 1
2 4 3 1
2 6 3 1
3 2 4 1
6 2 7 1
6 4 7 1
9 1 10 1
