1 0 1 0 0 0 0
0 0 0 0 2 0 0
0 0 0 3 0 0 0
0 0 4 0 0 0 0
0 5 0 0 0 0 0
0 0 0 6 0 0 0
0 0 0 0 0 0 0
0 0 0 0 0 0 0
0 0 0 0 0 0 0
0 0 0 0 0 0 0
0 0 0 0 0 0 0
0 0 0 0 0 0 0
0 0 0 0 0 0 0
0 0 0 0 0 0 0
0 0 0 0 0 0 0
3
1 4 2 1
2 3 3 1
4 1 5 1