1 0 1 1 0 0 0 
0 0 0 0 1 0 0 
0 0 0 1 0 0 0 
0 0 0 0 0 0 0 
0 1 0 0 0 0 0 
0 0 0 0 0 0 0 
0 0 0 0 0 0 0 
0 0 0 0 0 0 0 
0 0 0 0 0 0 0 
0 0 0 0 0 0 0 
0 0 0 0 0 0 0 
0 0 0 0 0 0 0 
0 0 0 0 0 0 0 
0 0 0 0 0 0 0 
0 0 0 0 0 0 0
12
0 4 1 2
1 3 1 2
3 4 1 2
3 5 1 2
5 3 1 2
6 2 1 2
7 0 1 2
7 1 1 2
8 5 1 2
8 6 1 2
9 2 1 2
9 3 1 2