1 0 0 0 0 1 0 
0 0 0 1 0 0 0 
0 0 0 0 0 0 0 
0 0 0 0 0 1 0 
0 1 0 0 0 0 0 
0 0 0 1 0 0 0 
0 0 0 0 0 0 0 
0 0 1 0 0 0 1 
1 0 0 1 0 0 0 
0 0 0 0 1 0 0 
0 0 0 0 0 0 0 
0 0 0 0 0 0 0 
0 0 0 0 0 0 0 
0 0 0 0 0 0 0 
0 0 0 0 0 0 0
8
0 5 1 1
1 4 1 1
2 4 1 1
2 6 1 1
3 2 1 1
6 2 1 1
6 4 1 1
9 1 1 1
